Skylar - Test level
30
30
FFFFFFFFFFFFFFFFFFFFFFFFFFFFFF
FSSSSSSSSSSSSSSSSSSSSSSSSSSSSF
FSSSSSSSSSSSSSSSSSSSSSSSSSSSSF
FSSSSSSSSSSSSSSSSSSSSSSSSSSSSF
FSSSSSSSSSSSSSSSSSSSSSSSSSSSSF
FSSSSSFSSSSSSSSSSSSSSSSSSSSSSF
FSSSSSSSSSSSSSSSSSSSSSSSSSSSSF
FSSSSSSSSSSSSSSSSSSSSSSSSSSSSF
FSSSSSSSSSSSSSSSSSSSSSSSSSSSSF
FSSSSSSSSSSSSSSSSSSSSSSSSSSSSF
FSSSSSSSSSSSSSSSSSSSSSSSSSSSSF
FSSSSSSSSSSSSSSSSSSSSSSSSSSSSF
FSSSSSSSSSSSSSSSSSSSSSSSSSSSSF
FSSSSSSSSSSSSSSSSSSSSSSSSSSSSF
FSSSSSSSSSSSSSSSSSSSSSSSSSSSSF
FSSSSSSSSSSSSSSSSSSSSSSSSSSSSF
FSSSSSSSSSSSSSSSSSSSSSSSSSSSSS
FSSSSSSSSSSSSSSSSSSSSSSSSSFFFF
FSSSSSSSSSSSSSSSSSSSSSSSSFFFFF
FSSSSSSSSSSSSSSSSSSSSSSSFFFFFF
FSSSSSSSSSSSSSSSSSSSSSSSSSSSSS
FSSSSSSSSSSSSSSSSSSSSSSSSSSSSS
FSSSSSSSSSSSSSSSSSSSSSSSSSSSSS
FSSSSSSSSSSSSSSSSSSSSSSSSSFFFF
FSSSSSSSSSSFFSSSSSSSSSSFFFFFFF
FSSSSSSSSSSSSSSSSSSSFFFFFFFFFF
FSSSSSSSFFSSSSSSSSSSFFFFFFFFFF
FSSSSSSSSSSSSSSSSFFFFFFFFFFFFF
FSSSSSSSSSSSSSSSSFFFFFFFFFFFFF
FFFFFFFFFFFFFFFFFFFFFFFFFFFFFF