Skylar - Test level
30
15
FFFFFFFFFFFFFFFFFFFFFFFFFFFFFF
FSSSSSSSSSSSSSSSSSSSSSSSSSSSSF
FSSSSFFFSSSSSSSSSSSSSSSSSSSSSF
FSSSSSSSSSSSSSSSSSSSSSSSSSSSSF
FSSSSSSSSSSSSSSSSSSSSSSSSSSSSF
FSFFFSSSSSSSSSSSSSSSSSSSSSSSSF
FSSSSSSSSSSSSSSSSSSSSSSSSSSSSF
FSSSSSSSSSSHSSSSSSSSSSSSSSSSSF
FSSSSSSSSSSSSSSSSSSSSSSSSSSSSE
FSSSSSSSSSSSSSSSSSSSSSSSSSSSSE
FSFFFSSSSSSSSSSSSSSSSSSSSSSSSE
FSSSSSSSSSSSSSSSSSSSSSSSSSFFFF
FSSSSSSSSSSSSSSSSSSSSSSSFFFFFF
FSSSSSSSSSSSSSSSSSSFFFFFFFFFFF
FFFFFFFFFFFFFFFFFFFFFFFFFFFFFF