Skylar - Test level
30
15
FFFFFFFFFFFFFFFFFFFFFFFFFFFFFF
FSSSSSSSSSSSSSSSSSSSSSSSSSSSSF
FSSSSFFFSSSSSSSSSSSSSSSSSSSSSF
FSSSSSSSSSSSSSSSSSSSSSSSSSSSSF
FSSSSSSSSSSSSSSSSSSSSSSSSSSSSF
FSFFFSSSSSSSSSSSSSSSSSSSSSSSSF
FSSSSSSSSSSSSSSSSSSSSSSSSSSSSF
FSSSSSSSSSSSSSSSSSSSSSSSSSSSSF
FSSSSSSSSSSSSSSSSSSSSSSSSSSSSI
FSSSSSSSSSSSSSSSSSSSSSSSSSSSSI
FSFFFSSSSSSSSSSSSSSSSSSSSSSSSI
FSSSSSSSSSSSSSSSSSSSSSSSSSFFFF
FSSSSSSSSSSSSSSSSSSSSSSSFFFFFF
FSSSSSSSSSSSSSSSSSSFFFFFFFFFFF
FFFFFFFFFFFFFFFFFFFFFFFFFFFFFF