Speed & Gather - Level 1
30
15
FFFFFFFFFFFFFFFFFFFFFFFFFFFFFF
FSSSSSSSSSSSSSSSSSSSSSSSSSSSSF
FSSSSSSSSSSSSSSSSSSSSSSSSSSSSF
FSSSSSSSSSSSSSSSSSSSSSSSSSSSSF
FSSSSSSSSSSSSSSSSSSSSSSSSSSSSF
FSSSSSSSSSSSSSSSSSSSSSSSSSSSSF
FSSSSSSSSSSSSSSSSSSSSSSSSSSSSF
FSSSSSSSSSSSSSSSSSSSSSSSSSSSSF
FSSSSSSSSSSSSSSSSSSSSSSSSSSSSE
FSSSSSSSSSSSSSSSSSSSSSSSSSSSSE
FSSSSSSSSSSSSSSSSSSSSSSSSSSSSE
FSSSSSSSSHSSSSSSSSSSSSSSSSSFFF
FSSSSSSSSSSSSSSSSSSSSSSSFFFFFF
FSCSSSSSSSSSSSSSSSSSSFFFFFFFFF
FFFFFFFFFFFFFFFFFFFFFFFFFFFFFF