Skylar - Test level
10
10
FFFFFFFFFF
FSSSSSSSSF
FSSSSFFFSF
FSSSSSSSSF
FSSSSSSSSF
FSFFFSSSSF
FSSSSSSSSF
FSSSSSSSSF
FSSSSSSSSF
FFFFFFFFFF