Speed and Gather - Level 2
30
15
FFFFFFFFFFFFFFFFFFFFFFFFFFFFFF
FSSSSSSSSSSSSSSSSSSSSSSSSSSSSF
FSSSSSSSSSSSSSSSSSSSSSSSSSSSSF
FSSSSSSSSSSSSSSSSSSSSSSSSSSSSF
FSSSSSSSSSSSSSSSSSSSSSSSSSSSSF
FSSSSSSSSSSSSSSSSSSSSSSSSSSSSE
FSSSSSSSSSSSSSSSSSSSSSSSSSSSSE
FSSSSSSSSSSSSSSSSSSSSSSSSSSSSE
FSSSSSSSSSSSSSSSSSSSSSSSFFFFFF
FSSSSSSSSSSSSSSSSSSSSSSSSSSSSF
FCSSSSSSSSSSSSSSSSSFFFFSSSSSSF
FFFSSSSSSSSSSSSSSSSSSSSSSSSSSF
FFFFFFSSSSSSSSFFFFSSSSSSSSSSSF
FFFFFFFFFSSSSSSSSSSSSSSSSSSSSF
FFFFFFFFFFFFFFFFFFFFFFFFFFFFFF