Speed & Gather - Level 3
30
15
FFFFFFFFFFFFFFFFFFFFFFFFFFFFFF
FSSSSSSSSSSSSSSSSSSSSSSSSSSSSF
FSSSSSSSSHSSSSSSSSSSSSSSSSSSSF
FSSSSSSSSSSSSSSSSFFFFFSSSSSSSF
FSSSSSSSSSSFFFFFSSSSSSSSSSSSSF
FSSSSSSSSSSSSSSSSSSSSSSSSSSSSF
FSSSSFFFFFSSSSSSSSSSSSSSSSSSSF
FCSSSSSSSSSSSSSSSSSSSSSSSEESSF
FFFFSSSSSSSSSHSSSSSSSSSSSSSSSF
FSSSFSSSSSSSSSSSSSSSSSSSSSSSSF
FSSSSFFFFFSSSSSSSSSSSFFFFSSSSF
FSSSSSSSSSSSSSSSSSFSSSSSSSSSSF
FSSSSSSSSSSFFFFFSSSSSSSSSSSSSF
FSSSSSSSSSSSSSSSSSSSSSSSSSSSSF
FFFFFFFFFFFFFFFFFFFFFFFFFFFFFF