Speed & Gather - Level 4
30
15
FFFFFFFFFFFFFFFFFFFFFFFFFFFFFF
FSSSSSSSSSSSSSSSSSSSSSSSSSSSSE
FSSSSSSSSSSSSSSSSSSSSSSSSSSSSE
FSSSSSSSSSSSSSSSSSSSSSSSFFFFFF
FHSSSSFFSSFFSSFFSSFFSSFFSSSSSF
FSSSSSFFSSFFSSFFSSFFSSFFSSSSSF
FSSSFFSSFFSSFFSSFFSSFFSSFFSSSF
FCSSFFSSFFSSFFSSFFSSFFSSFFSSSF
FFFFSSFFSSFFSSFFSSFFSSFFSSFFSF
FFFFSSFFSSFFSSFFSSFFSSFFSSFFSF
FSSSFFSSFFSSFFSSFFSSFFSSFFSSFF
FSSSFFSSFFSSFFSSFFSSFFSSFFSSFF
FSFFSSFFSSFFSSFFSSFFSSFFSSFFSF
FSFFSSFFSSFFSSFFSSFFSSFFSSFFSF
FFFFFFFFFFFFFFFFFFFFFFFFFFFFFF