Speed & Gather - Level 5
30
15
FFFFFFFFFFFFFFFFFFFFFFFFFFFFFF
FSSSSSSSSSSSSSSSSSSSSSSSSSSSSF
FCSSSSSSSSSSSSSSSSSSSSSSSSSSSF
FFFFFFFSSSSSSSSSSSSSSSSSSSSSSF
FSSSSSSFSSSSSSSSSSSSSSSSSSSSSF
FSSSSSSSFSSSSSSSSSSSSSSSSSSSSF
FSSSSSSSSFSSSSSSSSSSSSSSSSSSSF
FSSSSSSSSSFSSSSSSSSSSSSSSSSSSF
FSSSSSSSSSSFSSSSSSSSSSSSSSSSSF
FSSSSSSSSSSSFSSSSSSSSSSSSSSSSF
FSSSSSSSSSSSSFSSSSSSSSSSSSSSSF
ESSSSSSSSSSSSSFFFFFFSSSSSHSSSF
ESSSSSSSSSSSSSSSSSSSSSSSSSSSSF
ESSSSSSSSSSSSSSSSSSSSSSSSSSPPF
FFFFFFFFFFFFFFFFFFFFFFFFFFFFFF